11111111111111111111111
10000000C001000C00000C1
100000010001C0000000001
10100101001000001010011
101001P0101010100010011
10E000001C00C0000000001
10000000001010000000001
11111111111111111111111
