11111111111111111111111
10000000C001000C00000C1
100000010001C0000000001
10100101001000001010011
101001P0101010100010011
101000001C00C000C000001
10000100001010000000001
1000C00000101000C000001
10000010000010000C01001
10000100001000000001011
1000C0100010100000010E1
11111111111111111111111
