111111111
100000011
1PC000C01
100000001
100000111
100000001
10010CCC1
100100001
100000001
1000C0CE1
100000011
100C01001
100010001
111111111