1111111111111111111111111111111111
1C0100000000000C00000C000000000001
11E100000C000000000000000000000001
10100101001000001010010E0000010101
1010010010101010001001000000010101
1P0000000C00C0000000000000000000C1
1000000000000000000000000000000001
1111111111111111111111111111111111
