111111111
1PCCC0C01
1CCCCC111
10CCCC1E1
111111111