111111111
1PC000001
10000C0E1
111111111